6 7 8 8 7 8 7 8 6 7 8 8 7 8 7 8 6 7 8 8 7 8 7 8 6 7 8 8 7 8 7 8
6 7 8 8 7 8 7 8 6 7 8 8 7 8 7 8 6 7 8 8 7 8 7 8 6 7 8 8 7 8 7 8
7 8 8 7 8 7 8 6 7 8 8 7 8 7 8 6 7 8 7 8 8 7 8 7 8 6 7 8 8 7 8 7
7 8 8 7 8 7 8 6 7 8 8 7 8 7 8 6 7 8 6 7 8 8 7 8 7 8 6 6 7 8 8 7
7 8 8 7 8 7 8 6 7 8 8 7 8 7 8 6 7 8 6 7 8 8 7 8 7 8 6 6 7 8 8 7
7 8 8 7 8 7 8 6 7 8 8 7 8 7 8 6 7 8 6 7 8 8 7 8 7 8 6 6 7 8 8 7
7 8 8 7 8 7 8 6 7 8 8 7 8 7 8 6 7 8 6 7 8 8 7 8 7 8 6 6 7 8 8 7
7 8 8 7 8 7 8 6 7 8 8 7 8 7 8 6 7 8 6 7 8 8 7 8 7 8 6 6 7 8 8 7
7 8 8 7 8 7 8 6 7 8 8 7 8 7 8 6 7 8 6 7 8 8 7 8 7 8 6 6 7 8 8 7
7 8 8 7 8 7 8 6 7 8 8 7 8 7 8 6 7 8 6 7 8 8 7 8 7 8 6 6 7 8 8 7
7 8 8 7 8 7 8 6 7 8 8 7 8 7 8 6 7 8 6 7 8 8 7 8 7 8 6 6 7 8 8 7
7 8 8 7 8 7 8 6 7 8 8 7 8 7 8 6 7 8 6 7 8 8 7 8 7 8 6 6 7 8 8 7
7 8 8 7 8 7 8 6 7 8 8 7 8 7 8 6 7 8 6 7 8 8 7 8 7 8 6 6 7 8 8 7
7 8 8 7 8 7 8 6 7 8 8 7 8 7 8 6 7 8 6 7 8 8 7 8 7 8 6 6 7 8 8 7